##########
#S.....#E#
###.##.#.#
#...#....#
#.#.#.#..#
##########