###############
#S#.....#.....#
#...#.#.#.###.#
#.##..#...#...#
#....#..#..####
##.#.#####..#E#
#..#.#....#.#.#
#.##.....#..#.#
#....#.#....#.#
####.#......#.#
#....##.#####.#
#.###...#.....#
#.#.#.#.#.#.###
#.....#...#...#
###############